{
    "width": 18,
    "height": 18,
    "boxes": [
        [0, 0, 1, 1, 0, 0, 0, 0, 0, 0, 0, 0, 0, 0, 1, 1, 0, 0],
        [0, 0, 1, 1, 0, 0, 0, 0, 0, 0, 0, 0, 0, 0, 1, 1, 0, 0],
        [0, 0, 1, 1, 0, 0, 2, 2, 0, 0, 2, 2, 0, 0, 1, 1, 0, 0],
        [0, 0, 1, 1, 0, 0, 2, 2, 0, 0, 2, 2, 0, 0, 1, 1, 0, 0],
        [0, 0, 2, 2, 0, 0, 1, 1, 0, 0, 1, 1, 0, 0, 2, 2, 0, 0],
        [0, 0, 2, 2, 0, 0, 1, 1, 0, 0, 1, 1, 0, 0, 2, 2, 0, 0],
        [0, 0, 0, 0, 0, 0, 1, 1, 0, 0, 1, 1, 0, 0, 0, 0, 0, 0],
        [0, 0, 0, 0, 0, 0, 1, 1, 0, 0, 1, 1, 0, 0, 0, 0, 0, 0],
        [1, 1, 1, 1, 0, 0, 3, 3, 0, 0, 3, 3, 0, 0, 1, 1, 1, 1],
        [1, 1, 1, 1, 0, 0, 3, 3, 0, 0, 3, 3, 0, 0, 1, 1, 1, 1],
        [0, 0, 0, 0, 0, 0, 1, 1, 0, 0, 1, 1, 0, 0, 0, 0, 0, 0],
        [0, 0, 0, 0, 0, 0, 1, 1, 0, 0, 1, 1, 0, 0, 0, 0, 0, 0],
        [0, 0, 2, 2, 0, 0, 1, 1, 0, 0, 1, 1, 0, 0, 2, 2, 0, 0],
        [0, 0, 2, 2, 0, 0, 1, 1, 0, 0, 1, 1, 0, 0, 2, 2, 0, 0],
        [0, 0, 1, 1, 0, 0, 2, 2, 0, 0, 2, 2, 0, 0, 1, 1, 0, 0],
        [0, 0, 1, 1, 0, 0, 2, 2, 0, 0, 2, 2, 0, 0, 1, 1, 0, 0],
        [0, 0, 1, 1, 0, 0, 0, 0, 0, 0, 0, 0, 0, 0, 1, 1, 0, 0],
        [0, 0, 1, 1, 0, 0, 0, 0, 0, 0, 0, 0, 0, 0, 1, 1, 0, 0]
    ],
    "starting_positions": [
        [0.5, 0.5, 0],
        [17.5, 0.5, 0],
        [0.5, 17.5, 180],
        [17.5, 17.5, 180]
    ],
    "flag_pos": [9.5, 9.5]
}
