{
    "width": 24,
    "height": 24,
    "boxes": [
        [0, 0, 1, 1, 0, 0, 0, 0, 0, 0, 0, 0, 0, 0, 1, 1, 0, 0, 0, 0, 0, 0, 0, 0],
        [0, 0, 1, 1, 0, 0, 0, 0, 0, 0, 0, 0, 0, 0, 1, 1, 0, 0, 0, 0, 0, 0, 0, 0],
        [0, 0, 1, 1, 0, 0, 2, 2, 0, 0, 2, 2, 0, 0, 1, 1, 0, 0, 0, 0, 0, 0, 1, 1],
        [0, 0, 1, 1, 0, 0, 2, 2, 0, 0, 2, 2, 0, 0, 1, 1, 0, 0, 0, 0, 0, 0, 1, 1],
        [0, 0, 2, 2, 0, 0, 1, 1, 0, 0, 1, 1, 0, 0, 2, 2, 0, 0, 0, 0, 0, 0, 2, 2],
        [0, 0, 2, 2, 0, 0, 1, 1, 0, 0, 1, 1, 0, 0, 2, 2, 0, 0, 0, 0, 0, 0, 2, 2],
        [0, 0, 0, 0, 0, 0, 1, 1, 0, 0, 1, 1, 0, 0, 0, 0, 0, 0, 0, 0, 0, 0, 0, 0],
        [0, 0, 0, 0, 0, 0, 1, 1, 0, 0, 1, 1, 0, 0, 0, 0, 0, 0, 0, 0, 0, 0, 0, 0],
        [1, 1, 1, 1, 0, 0, 3, 3, 0, 0, 3, 3, 0, 0, 1, 1, 1, 1, 0, 0, 3, 3, 0, 0],
        [1, 1, 1, 1, 0, 0, 3, 3, 0, 0, 3, 3, 0, 0, 1, 1, 1, 1, 0, 0, 3, 3, 0, 0],
        [0, 0, 0, 0, 0, 0, 1, 1, 0, 0, 1, 1, 0, 0, 0, 0, 0, 0, 0, 0, 0, 0, 0, 0],
        [0, 0, 0, 0, 0, 0, 1, 1, 0, 0, 1, 1, 0, 0, 0, 0, 0, 0, 0, 0, 0, 0, 0, 0],
        [0, 0, 2, 2, 0, 0, 1, 1, 0, 0, 1, 1, 0, 0, 2, 2, 0, 0, 0, 0, 0, 0, 2, 2],
        [0, 0, 2, 2, 0, 0, 1, 1, 0, 0, 1, 1, 0, 0, 2, 2, 0, 0, 0, 0, 0, 0, 2, 2],
        [0, 0, 1, 1, 0, 0, 2, 2, 0, 0, 2, 2, 0, 0, 1, 1, 0, 0, 0, 0, 0, 0, 1, 1],
        [0, 0, 1, 1, 0, 0, 2, 2, 0, 0, 2, 2, 0, 0, 1, 1, 0, 0, 0, 0, 0, 0, 1, 1],
        [0, 0, 1, 1, 0, 0, 0, 0, 0, 0, 0, 0, 0, 0, 1, 1, 0, 0, 0, 0, 0, 0, 1, 1],
        [0, 0, 1, 1, 0, 0, 0, 0, 0, 0, 0, 0, 0, 0, 1, 1, 0, 0, 0, 0, 0, 0, 1, 1],
        [0, 0, 2, 2, 0, 0, 3, 3, 0, 0, 3, 3, 0, 0, 2, 2, 0, 0, 0, 0, 0, 0, 2, 2],
        [0, 0, 2, 2, 0, 0, 3, 3, 0, 0, 3, 3, 0, 0, 2, 2, 0, 0, 0, 0, 0, 0, 2, 2],
        [0, 0, 0, 0, 0, 0, 1, 1, 0, 0, 1, 1, 0, 0, 0, 0, 0, 0, 0, 0, 0, 0, 0, 0],
        [0, 0, 0, 0, 0, 0, 1, 1, 0, 0, 1, 1, 0, 0, 0, 0, 0, 0, 0, 0, 0, 0, 0, 0],
        [0, 0, 1, 1, 0, 0, 2, 2, 0, 0, 2, 2, 0, 0, 1, 1, 0, 0, 0, 0, 0, 0, 0, 0],
        [0, 0, 1, 1, 0, 0, 2, 2, 0, 0, 2, 2, 0, 0, 1, 1, 0, 0, 0, 0, 0, 0, 0, 0]
    ],
    "starting_positions": [
        [0.5, 0.5, 0],
        [23.5, 0.5, 0],
        [0.5, 23.5, 180],
        [23.5, 23.5, 180]
    ],
    "flag_pos": [12.5, 12.5]
}
